#############/#
#     |       #
#     #       #
#     #       #
#######       #
#     _       #
###############

1 1
1 2
1 3
5 6
4 2
1 1
1 2
5 5
5 5
9 1
7 5
2 2
